1111111111111111
1C11111001111111
101C10001C111111
1000001C10101111
10110110100000E1
1001100000001111
100P0000000000C1
1111111111111111
