11111111111111111111111111
10000000000C11111111111111
110000000C0001111111111111
111111111E100000C00C001011
11111111111111110000000P11
11111111111111111111111111
