1111111111111
10010000000C1
1000111110011

1P0011E000001
1111111111111
1110000011111
1111111111111
