11111111111111
1P000000C01111
10101111101011
10001000101101
10111010101101
1C001010100101
11101010111011
10001010001001
10101110111011
100C0000000011
11101111101111
1C0000000000E1
10111111111111
1C000000000001
11111111111111
