1111111111111111111111111111111111
11100001E000000C00000C100000000001
1010010100100000101001100000010101
1011010010101010001001100000010101
1P0000000C10C000000000100000000011
1111111111111111111111111111111111
