1111111111111111111111111111111111
111000010000000C00000C100000000001
1010010100100100101001100000010101
1011010010101E10001001100000010101
1P0000000C10CC00000000100000000011
1111111111111111111111111111111111
