1111111111111
1P00000000111
1010111110101
10001C0010101
101110101C101
1C00101C10011
1110101011101
100010100C101
1010111011101
100C0000000E1
1110111111111
1C00000000001
1111111111111
