111111111111
100C10011111
100C0C00E001
100PC0011011
1			1
111111111111
