1111111111111
10000000000C1
1000111110011
1P0011EC00001
1111111111111
1110000111111
1111111111111
