1111111111111
1CCCCC00000C1
1000111110011
1P0011EC00001
1111111111111
1110000111111
1111111111111
fjdsifjd
