111111
101001
101101
100101
101E01
10C001
111111
